F 255, 255, 255
C 255, 255, 255

NO textures/spiral.xpm
SO textures/spiral.xpm
WE textures/spiral.xpm
EA textures/spiral.xpm

1111111111111111111
1E01001001001000001
1011000001000001001
1001001001111101111
1001111000001001001
1000000000000001001
1001111111111001001
1111000000000001011
1000000001000000001
1111111111111111111


