NO textures/no.xpm
SO textures/so.xpm
WE textures/we.xpm
EA textures/ea.xpm

F 30, 40, 25
C 20, 28, 48

111111111111111111111
1W0000000000000000001
111111111111111111111
