NO textures/spiral.xpm
SO textures/spiral.xpm
WE textures/spiral.xpm
EA textures/spiral.xpm

F 255, 255, 255
C 255, 255, 255

111111111111111111111
1000000000000000000E1
111111111111111111111
