NO textures/North.xpm
SO textures/South.xpm
WE textures/Ouest.xpm
EA textures/East.xpm

F 255, 255, 255
C 255, 255, 255

11111111111111111111
10000000000000001001
1S000100001100000001
10000000000000000001
10000000010000000001
10000100000001001001
10000000000000000001
10000000000000000001
10000000000000000001
10000000000000000001
10000000000000000001
10000000000000000001
10000000000000000001
11111111111111111111