NO textures/no.xpm
SO textures/so.xpm
WE textures/we.xpm
EA textures/ea.xpm

F 30, 40, 25
C 20, 28, 48

1111
1001
1111
    
1111
1001
1111