NO textures/no.xpm
SO textures/so.xpm
WE textures/we.xpm
EA textures/ea.xpm

F 30, 40, 25
C 20, 28, 48

111111
100001
111111
      
111111
100N01
111111
