NO textures/spiral.xpm
SO textures/spiral.xpm
WE textures/spiral.xpm
EA textures/spiral.xpm

F 255, 255, 255
C 255, 255, 255

11011
10001
10S01
10001
10001
10001
11001
10001
10001
10001
10001
10001
11111
