NO textures/no.xpm
SO textures/so.xpm
WE textures/we.xpm
EA textures/ea.xpm

F 30, 40, 25
C 20, 28, 48

11111
10001
10S01
10001
10001
10001
11000
10001
10001
10001
10001
10001
11111
