NO textures/abastian.xpm
SO textures/leaugust.xpm
WE textures/fsingh.xpm
EA textures/jbanchon.xpm

F 220,100,0
C 225,30,0

111111111111111111111111111111
100000000000000000000000000001
100000000000000000000000000001
100000000000000000000000000001
100000000000000000000000000001
100000000000000000000000000001
100000000000000000000000000001
100000000000000000000000000001
100000000000000000000000000001
100000000000000000000000000001
100000000000000000000000000001
100000000000000000000000000001
100000000000000000000000000001
100000000000000000000000000001
10000000000000000000N000000001
100000000001111111000000000001
100000000000000000000000000001
100000000000000000000000000001
100000000000000000000000000001
100000000000000000000000000001
100000000000000000000000000001
100000000000000000000000000001
100000000000000000001110000001
100000000000000000000000000001
100000000000000000000000000001
100000000000000000000000011111
100000000000000000000000011111
100000000000000000000000011111
100000000000000000000000011111
100000000000000000000000011111
100000000000000000000000011111
100000000000000000000000011111
100000000000000000000000011111
100000000000000000000000011111
100000000000000000000000011111
100000000000000000000000011111
100000000000000000000000011111
100000000000000000000000011111
100000000000000000000000011111
100000000000000000000000011111
100000000000000000000000011111
100000000000000000000000011111
100000000000000000000000011111
100000000000000000000000011111
100000000000000000000000011111
100000000000000000000000011111
100000000000000000000000011111
100000000000000000000000011111
100000000000000000000000011111
100000000000000000000000011111
100000000000000000000000011111
100000000000000000000000011111
100000000000000000000000011111
100000000000000000000000011111
100000000000000000000000011111
100000000000000000000000011111
111111111111111111111111111111