NO ./path_to_the_north_texture
SO ./path_to_the_south_texture
WE ./path_to_the_west_texture
EA ./path_to_the_east_texture

F 220,100,0
C 225,30,0

111111111111111111111111111111
100000000000000000000000000001
100000000000000000000000000001
100000000000000000000000000001
100000000000000000000000000001
100000000000000000000000000001
100000001111111111110000000001
100000001000011000010000000001
100000001000011000010000000001
100000001111111111110000000001
100000001000000000010000000001
100000001000000000010000000001
100000001000000000010000000001
100000001000000000010000000001
10000000100000000001N000000001
100000001000000000010000000001
100000001000000000010000000001
100000001000000000010000000001
100000001000000000010000000001
100000001000000000010000000001
100000001000000000010000000001
100000001000000000010000000001
100000001000000000010000000001
100000001000000000010000000001
100000001000000000010000000001
100000001000000000010000000001
100000001000000000010000000001
100000001000000000010000000001
100000001000000000010000000001
100000001000000000010000000001
100000001000000000010000000001
100000001000000000010000000001
100000001000000000010000000001
100000001000000000010000000001
100000001000000000010000000001
100000001000000000010000000001
100000001000000000010000000001
100000001000000000010000000001
100011111000000000011111000001
100010001000000000010001000001
100010001000000000010001000001
100010001000000000010001000001
111111111111111111111111111111